1111111
0010001
1010101
1000101
1010001
1010101
1010101
1000000
1010111
1111111
(0, 1), (6, 7)