11111111111111
00000000000001
11101011111111
10101011111001
10100010001101
10101111100001
10000000001101
10111111011001
10000000001011
10101110111001
10000100000011
11111111011111
(0, 1), (8, 11)