1111111111111111111111111111111
0000001000100000000000100010001
1011101010101111111110101011101
1000101010100000100010101000001
1111101010111110101010101111111
1000001010100000101010000000101
1011101010111011101011111110101
1010000010000000001000100000101
1011111111111111111110101111101
1010000000000000000000100000001
1010111111111111111110111111111
1010001000100000000010000010001
1011101010101111111010111011101
1000001010001000100010001000001
1110111011101010101110101111111
1000000010001010100000101000001
1010111110111011111110111011111
1010001000101000110000100010001
1011101011101110101011101110101
1010001010001000101010001000101
1010111010111011101010111011101
1010100010001010001010101000101
1010111111101010111010101110101
1010000000001000100010001000101
1011111110111111111011101011111
1000000010000000001000000000101
1111111111111111101110111110101
1000100000001000100010000010001
1011101111111010111010111011111
1000000000000010000000001000000
1111111111111111111111111111111
(0, 1), (30, 29)