11111111111
00001000001
11101011101
10001010001
10111010111
10100010001
10101010101
10101010101
10101010101
10001010100
11111111111
(0, 1), (10, 9)